25 24 24 24 24 24 24 24 24 24 24 24 24 24 24 24 24 24 24 24 24 24 24 24 26 
23 14 14 15 14 15 14 15 14 14 14 15 14 14 14 14 14 14 14 14 14 14 14 14 23
14 14 14 14 14 14 14 14 14 15 14 14 14 14 14 14 14 15 15 14 14 14 14 15 23
23 14 15 14 15 14 15 14 14 14 15 14 14 14 14 14 15 14 14 15 14 14 15 14 23
23 14 14 14 14 14 14 14 14 14 14 15 14 14 14 14 14 14 14 14 14 14 14 14 23
23 14 14 15 15 15 14 15 14 15 14 14 14 14 14 14 15 14 14 14 15 14 15 14 23
23 14 14 14 14 14 14 14 14 14 14 14 14 14 14 14 15 14 14 14 14 15 14 14 23
23 14 14 15 15 14 14 14 14 14 14 15 14 15 14 14 14 14 15 14 14 15 14 14 23
23 14 14 14 14 14 14 14 14 14 15 14 14 14 14 15 14 14 14 14 14 14 15 14 23
23 14 15 15 14 15 15 14 14 15 14 14 14 15 14 14 14 14 15 14 14 15 14 14 23
23 15 14 14 14 14 14 14 14 14 14 14 14 15 14 15 14 14 14 15 14 14 14 14 23
23 14 14 14 14 14 14 14 14 14 14 15 14 15 14 14 14 14 15 14 14 15 14 14 14
23 14 15 14 14 14 15 14 14 15 14 14 14 14 14 15 14 14 14 15 14 14 15 14 14
23 14 14 14 15 14 14 14 14 14 14 15 14 15 14 14 14 15 14 14 14 14 14 14 14
21 20 20 20 20 20 20 20 20 20 20 20 20 20 20 20 20 20 20 20 20 20 20 20 22 