25 24 24 24 24 24 24 24 24 24 24 24 24 24 24 24 24 24 24 24 24 24 24 24 26 
23 14 14 14 14 14 14 14 14 14 14 14 14 14 14 14 14 14 14 14 14 14 14 14 23
14 14 14 14 14 11 14 14 14 14 14 14 13 14 14 14 14 14 14 14 14 14 14 14 23
23 14 14 14 14 14 14 14 12 14 14 14 15 14 12 15 15 15 15 14 15 15 15 14 23
23 14 15 15 15 15 15 15 15 15 14 14 14 14 14 14 14 14 14 14 14 14 14 11 23
23 14 14 14 14 10 14 15 14 14 14 14 14 14 14 15 15 15 15 14 15 15 15 14 23
23 14 14 14 14 14 14 15 14 14 14 14 14 14 13 14 14 14 14 14 14 14 14 14 23
23 14 14 14 15 15 15 15 14 14 14 15 15 15 15 15 14 13 14 14 14 14 14 14 23
23 14 14 14 14 14 14 14 14 14 14 14 14 14 14 14 14 14 14 14 14 14 14 14 23
23 14 14 14 14 14 14 14 14 14 14 14 14 15 14 15 15 14 14 14 14 14 14 14 23
23 14 14 14 11 14 14 14 14 14 14 15 14 14 14 14 14 14 14 14 15 14 14 14 23
23 14 10 14 15 14 14 14 14 14 14 14 14 14 14 14 14 14 14 14 14 14 14 13 14
23 14 14 14 14 14 14 14 14 14 15 10 14 15 15 14 14 14 14 14 14 14 14 14 14
23 14 14 14 14 14 12 14 14 14 14 14 14 14 14 14 14 14 14 14 14 14 14 14 14
21 20 20 20 20 20 20 20 20 20 20 20 20 20 20 20 20 20 20 20 20 20 20 20 22 